111111111111111111111111111111111111111111111111111111111111
100000000000000000000000000000000000000000000000000000000001
100001000000000000000000000000000000000000000000000000000001
100011000000000000000000000000000000000000000000000000000001
100001000000000000000000000000000000000000000000000000000001
100001000000000001111111111111111111000000000000000000000001
100001000000000000000000000000000000000000000000000000000001
100111110000000000000000000000000000000000000000000000000001
100000000000000000000000000000000000000000000000000000000001
100000000000000000000000000000000010000000000000000000000001
100000000000000000000000000000000010000000000000000000000001
100000000000000000000000000000000010000000000000000000000001
100000000000000000000000000000000010000000000000000000000001
100000000000000000000000000000000010000000000000000000000001
100000000000000000000000000000000010000000000000000000000001
100000000000000000000000000000000010000000000000000000000001
100000000000000000000000000000000010000000000000000000000001
100000000000000000000000000000000010000000000000000000000001
100000000000000000000000000000000010000000000000000000000001
100000000000000000000000000000000010000000000000000000000001
100000000000000000000000000000000000000000000000000000000001
100000000000000000000000000000000000000000000000000000000001
100000000000000000000000000000000000000000000000000000000001
100000000000000000000000000000000000000000000000000000000001
100000111111111111111100000000000000000000000000000000000001
100000000000000000000000000000000000000000000000000000000001
100000000000000000000000000000000011111111111111100000000001
100000000000000000000000000000000000000000000000000000000001
100000000000000000000000000000000000000000000000000000000001
111111111111111111111111111111111111111111111111111111111111